11111111.................
11111111.................
11111111........11.......
11111111........11.......
11111111.................
.........................
.........................
...........1111..........
.......P...1111..........
...........1111..........
11.......................
11.......................
1111.....................
1111.....................
11111111111111111111111..
11111111111111111111111..
11111111111111111111111..